000000000000000000000000000001
000000000000000000000000000001
000000000000000000000000000001
000000000000000000000000000001
0>00000@00000<0001000000000001
111111111111110000000111111111
000000000000000000001000000001
000000000000000000010000000001
000000000>000@000<000000000001
000000001111111111000000000001
000000010000000000000000000001
000000100000000000000000000001
0000010000000000>00@0000<00001
000000000000000011111111110001
111111111110000000000000000011
000000000000000000000000000101
P0000>00@0000000000<0000001001
111111111111111111111111111111