00000000000000000000000000000
00000000000000000000000000000
00000000000000000000000000000
00000000000000000000000000000
0>00000@00000<000100000000000
11111111111111000000011111111
00000000000000000000100000000
00000000000000000001000000000
000000000>000@000<00000000000
00000000111111111100000000000
00000001000000000000000000000
00000010000000000000000000000
0000010000000000>00@0000<0000
00000000000000001111111111000
11111111111000000000000000001
00000000000000000000000000010
P0000>00@0000000000<000000100
111111111111111111111111111111