00000000000000000000000001
00000000000000000000000001
00000000000000000000000001
00000000000000000000000001
00000000000000000000000001
0>00000@00000<000100000001
11111111111111000000111111
00000000000000000001000001
000000000>000@000<00000001
00000000111111111100000001
00000001000000000000000001
00000010000000000000000001
0000010000000000>00@0000<1
00000000000000001111111111
11110000000000010000000001
00001000000000100000000001
P0000>000@00<1000000000001
11111111111111111111111111